{"cherry":[
["     ___      "],
["     // \\     "],
["    //  _\\_   "],
["   _\\_/    \  "],
[" /    \     \ "],
["/      \     |"],
["|      |     /"],
["\      /____/ "],
[" \____/       "]],
"bell":[
["      ___     "],
["    _((_))_   "],
["   /       \  "],
[" _/         \_"],
[" |           |"],
[" |           |"],
[" |           |"],
[" |___________|"],
["      (O)     "]],
"lemon":[
["     _/\_     "],
["    /    \    "],
["  /        \  "],
[" |`        `| "],
[" |          | "],
[" |_         | "],
["  \        /` "],
["    \_  _/    "],
["      \/      "]],
"orange":[
["      _ -\    "],
["   _/`    `\. "],
["  /         '_"],
[" /           :"],
["|            |"],
["\`           /"],
[" \           -"],
["  `\._     _/ "],
["      `--+`   "]],
"star":[
["      /\      "],
["     /  \     "],
["____/    \____"],
["\            /"],
[" \          / "],
["  \   /\   /  "],
["  / _/  \_ \  "],
[" /_/      \_\ "],
["//         \\  "]],
"skull":[
["/\  ______  /|"],
["\ \/______\/ /"],
[" \/ (x)(x) \/ "],
["  |  /^^\  |  "],
["  \ \____/ /  "],
[" /(--------)\ "],
["/ /        \ |"],
["\/          \/"],
["              "]]}