 ________________________________________
| Balance: £%s                         |
| _____________________________________ |
| |:::::::::::::::::::::::::::::::::::| | 
| |:  _ _     _   _  _  _    _    _  :| |
| |: |_|_|| |||  |\/|_|| |_|||\ ||_  :| |
| |: | | \\_/||  |  | ||_| ||| \||_  :| |
| |:::::::::::::::::::::::::::::::::::| |
| '-----------------------------------' |
|   _________________________________   |
|   |  %s  |  %s  |  %s |   |
|   ---------------------------------   |
|_______________________________________|
|  %s |
|_______________________________________|